TTTTTTTTTTTTTTT
T000000T00000AT
T0TTT000T000T0T
T0900000000T00T
T0T0TTT0TT0T00T
T0T00000000T00T
T0T0T0TTT000T0T
T000T0000E0000T
T0TTT0TTT0TTT0T
T0000000000000T
T0TTT0T000T0TTT
T00A000T000000T
T0000T0000A000T
T0000000000000T
TTTTTTTTTTTTTTT