TTTTTTTTTTTTTTT
T0000000000000T
T0000000000000T
T0000000000000T
T0000000000000T
T0000PPPPP0000T
T0000PCGCP0000T
T0000PCCCPOOOOT
T0000PCCCP0000T
T0000PPCPP0000T
T0000000000000T
T0000000000000T
T0000000000000T
T000009000000OT
TTTTTTTTTTTTTTT