TTTTTTTTTTTTTTT
T0B00000000000T
T000000000B000T
T00000E000B000T
T00000000000B0T
T00B000000B0B0T
T00B0000000000T
T000B0000B0000T
T0000000000000T
T0B0B00B0000B0T
T0000000000000T
T00B000000B000T
T0B0000000B000T
TB00009000B000T
TTTTTTTTTTTTTTT